CastleThieves
An Interactive Fiction by Trevor Kam
Release 1 / Serial number 170214 / Inform 7 build 6M62 (I6/v6.33 lib 6/12N) SD

castle's border
you see a portcullis, a heavy gate that can only be opened from the inside, blocking you from your goal. Are you going to let that stop you? heck no! this is child's play, but really how do you get inside?

You can see portcullis here.

>i
You are carrying:
  ladder

>w
west border
You can see window here.

* * *

CastleThieves
An Interactive Fiction by Trevor Kam
Release 1 / Serial number 170214 / Inform 7 build 6M62 (I6/v6.33 lib 6/12N) SD

castle's border
you see a portcullis, a heavy gate that can only be opened from the inside, blocking you from your goal. Are you going to let that stop you? heck no! this is child's play, but really how do you get inside?

You can see portcullis here.

>n
castle
A big grey, old castle. The kind you think you would see if you lived in medieval times.

>down
You can't go that way.

* * *

>n
castle
A big grey, old castle. The kind you think you would see if you lived in medieval times.

>go down
You can't go that way.

* * *

CastleThieves
An Interactive Fiction by Trevor Kam
Release 1 / Serial number 170214 / Inform 7 build 6M62 (I6/v6.33 lib 6/12N) SD

castle's border
you see a portcullis, a heavy gate that can only be opened from the inside, blocking you from your goal. Are you going to let that stop you? heck no! this is child's play, but really how do you get inside?

You can see portcullis here.

>w
west border

>n
west tower