you are an international thief. you heard from a friend that there was a castle in the middle of a forest, and the owner just went out to a dinner party. It is 9:00pm and you have about 2 hours to get in, steal anything precious and get out.

CastleThieves
An Interactive Fiction by Noa Kam
Release 1 / Serial number 170227 / Inform 7 build 6M62 (I6/v6.33 lib 6/12N) SD

castle's border
you see a portcullis, a heavy gate, blocking you from your goal. Are you going to let that stop you? heck no! this is child's play, but really how do you get inside?

You can see portcullis here.

I beg your pardon?

I beg your pardon?

>w
west border
you are west of the castle. a suspicious rock wall makes up entire west tower, maybe you should check it out. but you also see an open window on the upper west tower, maybe you could use your parkour skills and somehow climb up there and get inside.

    *** The End ***

Would you like to RESTART, RESTORE a saved game, QUIT or UNDO the last command?

>x wall
Please give one of the answers above.

Would you like to RESTART, RESTORE a saved game, QUIT or UNDO the last command?

>n
Please give one of the answers above.

Would you like to RESTART, RESTORE a saved game, QUIT or UNDO the last command?

>e
Please give one of the answers above.

Would you like to RESTART, RESTORE a saved game, QUIT or UNDO the last command?

>e
Please give one of the answers above.

Would you like to RESTART, RESTORE a saved game, QUIT or UNDO the last command?

>u
Please give one of the answers above.

Would you like to RESTART, RESTORE a saved game, QUIT or UNDO the last command?

>d
Please give one of the answers above.

Would you like to RESTART, RESTORE a saved game, QUIT or UNDO the last command?

>w
Please give one of the answers above.

Would you like to RESTART, RESTORE a saved game, QUIT or UNDO the last command?

>w
Please give one of the answers above.

Would you like to RESTART, RESTORE a saved game, QUIT or UNDO the last command?

>u
Please give one of the answers above.

Would you like to RESTART, RESTORE a saved game, QUIT or UNDO the last command?

>take grilled cheese
Please give one of the answers above.

Would you like to RESTART, RESTORE a saved game, QUIT or UNDO the last command?

>d
Please give one of the answers above.

Would you like to RESTART, RESTORE a saved game, QUIT or UNDO the last command?

>e
Please give one of the answers above.

Would you like to RESTART, RESTORE a saved game, QUIT or UNDO the last command?

>n
Please give one of the answers above.

Would you like to RESTART, RESTORE a saved game, QUIT or UNDO the last command?

>n
Please give one of the answers above.

Would you like to RESTART, RESTORE a saved game, QUIT or UNDO the last command?

>talk to toddler
Please give one of the answers above.

Would you like to RESTART, RESTORE a saved game, QUIT or UNDO the last command?

>x toddler
Please give one of the answers above.

Would you like to RESTART, RESTORE a saved game, QUIT or UNDO the last command?

>ask toddler about treasure
Please give one of the answers above.

Would you like to RESTART, RESTORE a saved game, QUIT or UNDO the last command?

>give toddler grilled cheese
Please give one of the answers above.

Would you like to RESTART, RESTORE a saved game, QUIT or UNDO the last command?

>s
Please give one of the answers above.

Would you like to RESTART, RESTORE a saved game, QUIT or UNDO the last command?

>x candle
Please give one of the answers above.

Would you like to RESTART, RESTORE a saved game, QUIT or UNDO the last command?

>open latch
Please give one of the answers above.

Would you like to RESTART, RESTORE a saved game, QUIT or UNDO the last command?

>yes
Please give one of the answers above.

Would you like to RESTART, RESTORE a saved game, QUIT or UNDO the last command?

>u
Please give one of the answers above.

Would you like to RESTART, RESTORE a saved game, QUIT or UNDO the last command?

>e
Please give one of the answers above.

Would you like to RESTART, RESTORE a saved game, QUIT or UNDO the last command?

>w
Please give one of the answers above.

Would you like to RESTART, RESTORE a saved game, QUIT or UNDO the last command?

>take torch
Please give one of the answers above.

Would you like to RESTART, RESTORE a saved game, QUIT or UNDO the last command?

>e
Please give one of the answers above.

Would you like to RESTART, RESTORE a saved game, QUIT or UNDO the last command?

>x rubble
Please give one of the answers above.

Would you like to RESTART, RESTORE a saved game, QUIT or UNDO the last command?

>look under rubble
Please give one of the answers above.

Would you like to RESTART, RESTORE a saved game, QUIT or UNDO the last command?

>i
Please give one of the answers above.

Would you like to RESTART, RESTORE a saved game, QUIT or UNDO the last command?

>n
Please give one of the answers above.

Would you like to RESTART, RESTORE a saved game, QUIT or UNDO the last command?

>unlock steel door
Please give one of the answers above.

Would you like to RESTART, RESTORE a saved game, QUIT or UNDO the last command?

>rusty key
Please give one of the answers above.

Would you like to RESTART, RESTORE a saved game, QUIT or UNDO the last command?

>open steel door
Please give one of the answers above.

Would you like to RESTART, RESTORE a saved game, QUIT or UNDO the last command?

>e
Please give one of the answers above.

Would you like to RESTART, RESTORE a saved game, QUIT or UNDO the last command?

>take king's treasure
Please give one of the answers above.

Would you like to RESTART, RESTORE a saved game, QUIT or UNDO the last command?

>x long key
Please give one of the answers above.

Would you like to RESTART, RESTORE a saved game, QUIT or UNDO the last command?

>take long key
Please give one of the answers above.

Would you like to RESTART, RESTORE a saved game, QUIT or UNDO the last command?

>x kings treasure
Please give one of the answers above.

Would you like to RESTART, RESTORE a saved game, QUIT or UNDO the last command?

>x king's treasure
Please give one of the answers above.

Would you like to RESTART, RESTORE a saved game, QUIT or UNDO the last command?

>w
Please give one of the answers above.

Would you like to RESTART, RESTORE a saved game, QUIT or UNDO the last command?

>s
Please give one of the answers above.

Would you like to RESTART, RESTORE a saved game, QUIT or UNDO the last command?

>w
Please give one of the answers above.

Would you like to RESTART, RESTORE a saved game, QUIT or UNDO the last command?

* * *

>s
Please give one of the answers above.

Would you like to RESTART, RESTORE a saved game, QUIT or UNDO the last command?

>unlock iron door
Please give one of the answers above.

Would you like to RESTART, RESTORE a saved game, QUIT or UNDO the last command?

>long key
Please give one of the answers above.

Would you like to RESTART, RESTORE a saved game, QUIT or UNDO the last command?

>w
Please give one of the answers above.

Would you like to RESTART, RESTORE a saved game, QUIT or UNDO the last command?

>e
Please give one of the answers above.

Would you like to RESTART, RESTORE a saved game, QUIT or UNDO the last command?

* * *

you are an international thief. you heard from a friend that there was a castle in the middle of a forest, and the owner just went out to a dinner party. It is 9:00pm and you have about 2 hours to get in, steal anything precious and get out.

CastleThieves
An Interactive Fiction by Noa Kam
Release 1 / Serial number 170227 / Inform 7 build 6M62 (I6/v6.33 lib 6/12N) SD

castle's border
you see a portcullis, a heavy gate, blocking you from your goal. Are you going to let that stop you? heck no! this is child's play, but really how do you get inside?

You can see portcullis here.

>e
east border
you are east of the castle. a rock wall makes up entire east tower.

>take
(long key)
Taken.

>w
castle's border
you see a portcullis, a heavy gate that can only be opened from the inside, blocking you from your goal. Are you going to let that stop you? heck no! this is child's play, but really how do you get inside?

You can see portcullis here.

>w
west border
you are west of the castle. a rock wall makes up entire west tower. you see an open window on the upper west tower, maybe you could use your parkour skills and somehow climb up there and get inside.

>x rock
 

You see a loose rock in the wall, you move it and a couple more rocks fall as well. the dust clears up and you can see a path to the castle. you're in!

>n
(first opening rock wall)
You crawl through the little space and make your way into the west tower.

west tower
you look around and notice the inside is a lot nice than the rock on the ouside. you see a bunch of bookcases and a spiraling staircase going up.

You can see rock wall and bookshelf (in which are green book, blue book, orange book, fat book, red book, skinny book and black book) here.

>u
upper west tower
there is nothing much to see up here. just an oak table with a pen and paper, this is probably someone's study. but I guess they ran out of books to put in the shelves up here.

You can see shelves and oak table here.

>take grilled cheese
Taken.

>d
west tower
you look around and notice the inside is a lot nice than the rock on the ouside. you see a bunch of bookcases and a spiraling staircase going up.

You can see rock wall and bookshelf (in which are green book, blue book, orange book, fat book, red book, skinny book and black book) here.

>e
courtyard
You are infont of a small grey, old castle. I'm not even sure if you could consider it a castle. It's in the middle of the forrest, which made it very difficult to find in the first place..

>n
castle
a large room.

>w
west corridor
a grassy open field, with a couple trees and a garden surrounded by a rock wall encasing the entire property.

toddler is playing around in the field, he seems to be completely focused in what he is doing.

>ask toddler about treasure
Im hungy... you must be my baby sitter for tonight. my mommy said my dinner is across the hall. if you get me some food maybe ill talk.

>give toddler grilled cheese
all right i'll help you. you asked about the treasure? first you have to go in the castle and open the latch in the ground, but that is all I can tell you.

>e
castle
a large room with a latch in the corner of it... I can't believe I never saw that before.

You can see latch here.

>open latch
Upon first opening the latch you see a couple cobwebs and a staircase leading down. Are you sure you want to go down the stairway?

Please answer yes or no.

* * *

>open latch
Upon first opening the latch you see a couple cobwebs and a staircase leading down. Are you sure you want to go down the stairway?

>yes
dungeon
A cold mossy room lit by a torch, with chains hanging from the walls, blood stains everywhere... You feel a chill run down your back.

You can see latch here.

>e
Darkness
It is pitch dark, and you can't see a thing.

>x rubble
You can't see any such thing.

>x rubble
You can't see any such thing.

>w
dungeon
A cold mossy room lit by a torch, with chains hanging from the walls, blood stains everywhere... You feel a chill run down your back.

You can see latch here.

>take torch
Taken.

* * *

I beg your pardon?

>w
west border
you are west of the castle. a rock wall makes up entire west tower. you see an open window on the upper west tower, maybe you could use your parkour skills and somehow climb up there and get inside.

>x rock wall
 

You see a loose rock in the wall, you move it and a couple more rocks fall as well. the dust clears up and you can see a path to the castle. you're in!

>n
(first opening rock wall)
You crawl through the little space and make your way into the west tower.

west tower
You can see rock wall here.

* * *

>e
east border
you are east of the castle. a rock wall makes up entire east tower.

>x rock wall
You can't see any such thing.

>x me
an internation thief, around 6 foot 3 inches, 185 pounds, or at least that's what your id says here.

>i
You are carrying:
  id
  to-do list

>x id
just your usual state id.

>x me
an internation thief, around 6 foot 3 inches, 185 pounds, or at least that's what your id says here.

* * *

you are an international thief. you heard from a friend that there was a castle in the middle of a forest, and the owner just went out to a dinner party. It is 9:00pm and you have about 2 hours to get in, steal anything precious and get out.

CastleThieves
An Interactive Fiction by Noa Kam
Release 1 / Serial number 170227 / Inform 7 build 6M62 (I6/v6.33 lib 6/12N) SD

castle's border
you see a portcullis, a heavy gate, blocking you from your goal. Are you going to let that stop you? heck no! this is child's play, but really how do you get inside?

You can see portcullis here.

>i
You are carrying:
  to-do list

>w
west border
You can see window here.

* * *

you are an international thief. you heard from a friend that there was a castle in the middle of a forest, and the owner just went out to a dinner party. It is 9:00pm and you have about 2 hours to get in, steal anything precious and get out.

CastleThieves
An Interactive Fiction by Noa Kam
Release 1 / Serial number 170227 / Inform 7 build 6M62 (I6/v6.33 lib 6/12N) SD

castle's border
you see a portcullis, a heavy gate, blocking you from your goal. Are you going to let that stop you? heck no! this is child's play, but really how do you get inside?

You can see portcullis here.

>n
(first opening portcullis)
It seems to be locked.

>down
You can't go that way.

>open stairway
It seems to be locked.

* * *

>n
(first opening portcullis)
It seems to be locked.

>go down
You can't go that way.

>down
You can't go that way.

>go down stairway
I only understood you as far as wanting to go down.

>go through stairway
You can't go that way.

>stairway
That's not a verb I recognise.

>down
You can't go that way.

* * *

>n
(first opening portcullis)
It seems to be locked.

>n
(first opening portcullis)
It seems to be locked.

>w
west border
you are west of the castle. a suspicious rock wall makes up entire west tower, maybe you should check it out. but you also see an open window on the upper west tower, maybe you could use your parkour skills and somehow climb up there and get inside.

>x rock
 

You see a loose rock in the wall, you move it and a couple more rocks fall as well. the dust clears up and you can see a path to the castle. you're in!

>n
(first opening rock wall)
You crawl through the little space and make your way into the west tower.

west tower
you look around and notice the inside is a lot nice than the rock on the outside. you see a bunch of bookcases and a spiraling staircase going up.

You can see rock wall and bookshelf (in which are green book, blue book, orange book, fat book, red book, skinny book and black book) here.

>u
upper west tower
there is nothing much to see up here. just an oak table with a pen and paper, this is probably someone's study. but I guess they ran out of books to put in the shelves up here.

You can see shelves and oak table here.

* * *

>take grilled cheese
Taken.

>d
west tower
you look around and notice the inside is a lot nice than the rock on the outside. you see a bunch of bookcases and a spiraling staircase going up.

You can see rock wall and bookshelf (in which are green book, blue book, orange book, fat book, red book, skinny book and black book) here.

>e
courtyard
You are in front of a small grey, old castle. I'm not even sure if you could consider it a castle. It's in the middle of the forest, which made it very difficult to find in the first place.

>n
castle
a large grand room, surrounded by stone walls, with a lit candle chandelier on the ceiling.

You can see candle chandelier here.

>n
north corridor
a grassy open field, with a couple trees and a garden surrounded by a rock wall encasing the entire property.

toddler is playing around in the field, he seems to be completely focused in what he is doing.

>task toddler about treasure
That's not a verb I recognise.

>ask toddler about treasure
I'm hungry... you must be my baby sitter for tonight. my mommy said my dinner is across the hall. if you get me some food maybe I'll talk.

>give toddler grilled cheese
all right I'll help you. you asked about the treasure? first you have to go in the castle and open the latch in the ground, but that is all I can tell you.

>s
castle
a large grand room, surrounded by stone walls, with a lit candle chandelier on the ceiling, with a latch in the corner of it... I can't believe I never saw that before.

You can see latch and candle chandelier here.

>open latch
Upon first opening the latch you see a couple cobwebs and a staircase leading down. Are you sure you want to go down the stairway?

>yas
Please answer yes or no.

>yas
Please answer yes or no.

>yes
dungeon
A cold mossy room lit by a torch, with chains hanging from the walls, blood stains everywhere... You feel a chill run down your back.

You can see latch here.

>u
the latch closed behind you, locking you down here. I wonder how you are going to get out now.

>e
Darkness
It is pitch dark, and you can't see a thing.

>look under rubble
You can't see any such thing.

>w
dungeon
A cold mossy room lit by a torch, with chains hanging from the walls, blood stains everywhere... You feel a chill run down your back.

You can see latch here.

* * *

>take torch
Taken.

>e
east hallway
a long narrow, stone hallway. it is kind of dark as your torch only lights up so much. rubble litters the ground, someone else must have tried to break in recently.

You can see rubble here.

>look under rubble
you move the rubble a little to reveal a little rusty key.

>n
upper east hallway
a long narrow, stone hallway. it is kind of dark as your torch only lights up so much. rubble litters the ground, someone else must have tried to break in recently.

You can see steel door here.

>s
east hallway
a long narrow, stone hallway. it is kind of dark as your torch only lights up so much. rubble litters the ground, someone else must have tried to break in recently.

You can see rubble here.

>w
dungeon
A cold mossy room lit by a torch, with chains hanging from the walls, blood stains everywhere... You feel a chill run down your back.

You can see latch here.

>w
west hallway
a long narrow, stone hallway. it is kind of dark as your torch only lights up so much. rubble litters the ground, someone else must have tried to break in recently.

>s
lower west hallway
a long narrow, stone hallway. it is kind of dark as your torch only lights up so much. rubble litters the ground, someone else must have tried to break in recently.

You can see iron door here.

>n
west hallway
a long narrow, stone hallway. it is kind of dark as your torch only lights up so much. rubble litters the ground, someone else must have tried to break in recently.

>e
dungeon
A cold mossy room lit by a torch, with chains hanging from the walls, blood stains everywhere... You feel a chill run down your back.

You can see latch here.

>e
east hallway
a long narrow, stone hallway. it is kind of dark as your torch only lights up so much. rubble litters the ground, someone else must have tried to break in recently.

You can see rubble here.

>n
upper east hallway
a long narrow, stone hallway. it is kind of dark as your torch only lights up so much. rubble litters the ground, someone else must have tried to break in recently.

You can see steel door here.

>unlock steel door
What do you want to unlock steel door with?

>rusty key
You unlock steel door.

>e
(first opening steel door)

treasure room
a small cramped room almost filled to the brim with treasure, whether it be gold, silver, precious jewels, and ornaments.

You can see steel door, King's Treasure and long key here.

>take king's treasure
Taken.

>take long key
Taken.

>w
upper east hallway
a long narrow, stone hallway. it is kind of dark as your torch only lights up so much. rubble litters the ground, someone else must have tried to break in recently.

You can see steel door here.

>s
east hallway
a long narrow, stone hallway. it is kind of dark as your torch only lights up so much. rubble litters the ground, someone else must have tried to break in recently.

You can see rubble here.

* * *

>s
lower west hallway
a long narrow, stone hallway. it is kind of dark as your torch only lights up so much. rubble litters the ground, someone else must have tried to break in recently.

You can see iron door here.

>unlock iron door
What do you want to unlock iron door with?

>long key
You unlock iron door.

>w
    *** you escaped with the treasure and not even a drip of sweat, congratulation! ***

Would you like to RESTART, RESTORE a saved game, QUIT or UNDO the last command?

* * *

you are an international thief. you heard from a friend that there was a castle in the middle of a forest, and the owner just went out to a dinner party. It is 9:00pm and you have about 2 hours to get in, steal anything precious and get out.

CastleThieves
An Interactive Fiction by Noa Kam
Release 1 / Serial number 170227 / Inform 7 build 6M62 (I6/v6.33 lib 6/12N) SD

castle's border
you see a portcullis, a heavy gate, blocking you from your goal. Are you going to let that stop you? heck no! this is child's play, but really how do you get inside?

You can see portcullis here.

>open portcullis
It seems to be locked.

>x me
As good-looking as ever.

>x
(to-do list)
checklist: before 11:00pm I need to get into the castle, find out where the treasure is, take it, and get out.

>west
west border
you are west of the castle. a rock wall makes up entire west tower. you see an open window on the upper west tower, maybe you could use your parkour skills and somehow climb up there and get inside.

>x climb wall
You can't see any such thing.

>climb wall
Little is to be achieved by that.

>w
You can't go that way.

>e
castle's border
you see a portcullis, a heavy gate that can only be opened from the inside, blocking you from your goal. Are you going to let that stop you? heck no! this is child's play, but really how do you get inside?

You can see portcullis here.

>e
east border
you are east of the castle. a rock wall makes up entire east tower. on this side the window is closed. there is no way you are getting in through here.

You can see long key here.

>take key
Taken.

>west
castle's border
you see a portcullis, a heavy gate that can only be opened from the inside, blocking you from your goal. Are you going to let that stop you? heck no! this is child's play, but really how do you get inside?

You can see portcullis here.

>unlock portcullis with key
That doesn't seem to fit the lock.

>west
west border
you are west of the castle. a rock wall makes up entire west tower. you see an open window on the upper west tower, maybe you could use your parkour skills and somehow climb up there and get inside.

>x wall
 

You see a loose rock in the wall, you move it and a couple more rocks fall as well. the dust clears up and you can see a path to the castle. you're in!

>x
What do you want to examine?

>north
You see nothing unexpected in that direction.

>s
You can't go that way.

>w
You can't go that way.

* * *

>e
castle's border
you see a portcullis, a heavy gate that can only be opened from the inside, blocking you from your goal. Are you going to let that stop you? heck no! this is child's play, but really how do you get inside?

You can see portcullis here.

>w
west border
you are west of the castle. a rock wall makes up entire west tower. you see an open window on the upper west tower, maybe you could use your parkour skills and somehow climb up there and get inside.

You can see rock wall here.

* * *

>n
(first opening rock wall)
You crawl through the little space and make your way into the west tower.

west tower
you look around and notice the inside is a lot nice than the rock on the ouside. you see a bunch of bookcases and a spiraling staircase going up.

You can see rock wall and bookshelf (in which are green book, blue book, orange book, fat book, red book, skinny book and black book) here.

>take book
Which do you mean, green book, blue book, orange book, fat book, red book, skinny book or black book?

>take green book
Taken.

>read green book
You see nothing special about green book.

>take blue book
Taken.

>read blue book
You see nothing special about blue book.

>take orange book
Taken.

>read orange book
You see nothing special about orange book.

>take fat book
Taken.

>read fat book
You see nothing special about fat book.

>take red book
Taken.

>read red book
You see nothing special about red book.

>take skinny book
Taken.

>read skinny book
You see nothing special about skinny book.

>take black book
Taken.

>read black book
You see nothing special about black book.

>up
upper west tower
there is nothing much to see up here. just an oak table with a pen and paper, this is probably someone's study. but I guess they ran out of books to put in the shelves up here.

You can see shelves and oak table here.

>take paper
Taken.

>take pen
You can't see any such thing.

>take shelves
That's fixed in place.

>take table
That's fixed in place.

>x paper
a piece of printer paper, with random letters, and characters on it. must be some sort of code for something.

>x shelves
empty, cobwebs cover the shelves. I wonder if anyone will ever clean this up.

>clean shelves
You rub shelves.

>x oak
a small cramped oak table with a lamp, pen, a bunch of papers spread out all over, and a grilled cheese sandwich in the corner.

>take lamp
You can't see any such thing.

>take grilled cheese
Taken.

>down
west tower
you look around and notice the inside is a lot nice than the rock on the ouside. you see a bunch of bookcases and a spiraling staircase going up.

You can see rock wall and bookshelf (empty) here.

>north
You can't go that way.

>west
You can't go that way.

>east
courtyard
You are infont of a small grey, old castle. I'm not even sure if you could consider it a castle. It's in the middle of the forrest, which made it very difficult to find in the first place..

>north
castle
a large room.

>n
north corridor

>n
You can't go that way.

>w
You can't go that way.

>e
You can't go that way.

>s
castle
a large room.

>w
west corridor
a grassy open field, with a couple trees and a garden surrounded by a rock wall encasing the entire property.

toddler is playing around in the field, he seems to be completely focused in what he is doing.

>talk to toddler
That's not a verb I recognise.

>ask toddler about grilled cheese
There is no reply.

>ask toddler about castle
There is no reply.

>ask toddler about treasure
Im hungy... you must be my baby sitter for tonight. my mommy said my dinner is across the hall. if you get me some food maybe ill talk.

* * *

>give toddler grilled cheese
all right i'll help you. you asked about the treasure? first you have to go in the castle and open the latch in the ground, but that is all I can tell you.

>n
You can't go that way.

>s
You can't go that way.

>e
castle
a large room with a latch in the corner of it... I can't believe I never saw that before.

You can see latch here.

you hear a clock strike 10 times, looks like it's 10 o'clock the owner of the castle is going to be home in just about another hour. better hurry up!

>open latch
Upon first opening the latch you see a couple cobwebs and a staircase leading down. Are you sure you want to go down the stairway?

>down
Please answer yes or no.

>yes
dungeon
A cold mossy room lit by a torch, with chains hanging from the walls, blood stains everywhere... You feel a chill run down your back.

You can see latch here.

>take torch
Taken.

>taste blood
You can't see any such thing.

>n
north hallway
a long narrow, stone hallway. it is kind of dark as your torch only lights up so much. rubble litters the ground, someone else must have tried to break in recently.

You can see debris here.

>x debris
broken tiles, dirt, and rocks clutter the ground but if you search around a little more maybe you'll find something or need.

>s
dungeon
A cold mossy room lit by a torch, with chains hanging from the walls, blood stains everywhere... You feel a chill run down your back.

You can see latch here.

>x blood
You can't see any such thing.

>n
north hallway
a long narrow, stone hallway. it is kind of dark as your torch only lights up so much. rubble litters the ground, someone else must have tried to break in recently.

You can see debris here.

>take dirt
You can't see any such thing.

>take tiles
You can't see any such thing.

>n
You can't go that way.

>e
You can't go that way.

>w
You can't go that way.

>s
dungeon
A cold mossy room lit by a torch, with chains hanging from the walls, blood stains everywhere... You feel a chill run down your back.

You can see latch here.

>s
You can't go that way.

>e
east hallway
a long narrow, stone hallway. it is kind of dark as your torch only lights up so much. rubble litters the ground, someone else must have tried to break in recently.

You can see rubble here.

>x rubble
broken rocks, stone, and bricks but if you search around a little more maybe you'll find something of need.

>south
You can't go that way.

>e
You can't go that way.

>s
You can't go that way.

>w
dungeon
A cold mossy room lit by a torch, with chains hanging from the walls, blood stains everywhere... You feel a chill run down your back.

You can see latch here.

* * *

>w
west hallway
a long narrow, stone hallway. it is kind of dark as your torch only lights up so much. rubble litters the ground, someone else must have tried to break in recently.

>x room
You can't see any such thing.

>x rubble
You can't see any such thing.

>e
dungeon
A cold mossy room lit by a torch, with chains hanging from the walls, blood stains everywhere... You feel a chill run down your back.

You can see latch here.

* * *

>e
east hallway
a long narrow, stone hallway. it is kind of dark as your torch only lights up so much. rubble litters the ground, someone else must have tried to break in recently.

You can see rubble here.

>x rubble
broken rocks, stone, and bricks but if you search around a little more maybe you'll find something of need.

you look around and find a rusty key.

>take key
Which do you mean, rusty key or long key?

>take rusty key
You already have that.

>i
You are carrying:
  rusty key
  torch (providing light)
  paper
  black book
  skinny book
  red book
  fat book
  orange book
  blue book
  green book
  long key
  to-do list

>n
upper east hallway
a long narrow, stone hallway. it is kind of dark as your torch only lights up so much. rubble litters the ground, someone else must have tried to break in recently.

You can see steel door here.

>unlock steel door with rusty key
You unlock steel door.

>n
You can't go that way.

* * *

>w
You can't go that way.

>e
(first opening steel door)

treasure room
a small cramped room almost filled to the brim with treasure, whether it be gold, silver, precious jewels, and ornaments.

You can see steel door and King's Treasure here.

>take treasure
Taken.

>n
You can't go that way.

* * *

>s
You can't go that way.

>e
You can't go that way.

>w
upper east hallway
a long narrow, stone hallway. it is kind of dark as your torch only lights up so much. rubble litters the ground, someone else must have tried to break in recently.

You can see steel door here.

>w
You can't go that way.

>e
treasure room
a small cramped room almost filled to the brim with treasure, whether it be gold, silver, precious jewels, and ornaments.

You can see steel door here.

>w
upper east hallway
a long narrow, stone hallway. it is kind of dark as your torch only lights up so much. rubble litters the ground, someone else must have tried to break in recently.

You can see steel door here.

>n
You can't go that way.

>s
east hallway
a long narrow, stone hallway. it is kind of dark as your torch only lights up so much. rubble litters the ground, someone else must have tried to break in recently.

You can see rubble here.

>s
You can't go that way.

* * *

>w
dungeon
A cold mossy room lit by a torch, with chains hanging from the walls, blood stains everywhere... You feel a chill run down your back.

You can see latch here.

>up
the latch closed behind you, locking you down here. I wonder how you are going to get out now.

>unlock latch with long key
That doesn't seem to fit the lock.

>unlock latch with rusty key
That doesn't seem to fit the lock.

>west
west hallway
a long narrow, stone hallway. it is kind of dark as your torch only lights up so much. rubble litters the ground, someone else must have tried to break in recently.

>west
You can't go that way.

>east
dungeon
A cold mossy room lit by a torch, with chains hanging from the walls, blood stains everywhere... You feel a chill run down your back.

You can see latch here.

>n
north hallway
a long narrow, stone hallway. it is kind of dark as your torch only lights up so much. rubble litters the ground, someone else must have tried to break in recently.

You can see debris here.

>n
You can't go that way.

>x debris
broken tiles, dirt, and rocks clutter the ground but if you search around a little more maybe you'll find something or need.

>x debris
broken tiles, dirt, and rocks clutter the ground but if you search around a little more maybe you'll find something or need.

>south
dungeon
A cold mossy room lit by a torch, with chains hanging from the walls, blood stains everywhere... You feel a chill run down your back.

You can see latch here.

>east
east hallway
a long narrow, stone hallway. it is kind of dark as your torch only lights up so much. rubble litters the ground, someone else must have tried to break in recently.

You can see rubble here.

>e
You can't go that way.

>n
upper east hallway
a long narrow, stone hallway. it is kind of dark as your torch only lights up so much. rubble litters the ground, someone else must have tried to break in recently.

You can see steel door here.

>n
You can't go that way.

>unlock steel door with rusty key
That's unlocked at the moment.

>e
treasure room
a small cramped room almost filled to the brim with treasure, whether it be gold, silver, precious jewels, and ornaments.

You can see steel door here.

>e
You can't go that way.

>n
You can't go that way.

>s
You can't go that way.

you hear a clock strike 11 times, looks like it's 11 o'clock the owner of the castle should be hoom real soon. now we really need to hurry up!

>up
You can't go that way.

>down
You can't go that way.

>south
You can't go that way.

>n
You can't go that way.

* * *

>w
upper east hallway
a long narrow, stone hallway. it is kind of dark as your torch only lights up so much. rubble litters the ground, someone else must have tried to break in recently.

You can see steel door here.

>up
You can't go that way.

* * *

>down
You can't go that way.

>south
east hallway
a long narrow, stone hallway. it is kind of dark as your torch only lights up so much. rubble litters the ground, someone else must have tried to break in recently.

You can see rubble here.

>up
You can't go that way.

* * *

>down
You can't go that way.

>east
You can't go that way.

>west
dungeon
A cold mossy room lit by a torch, with chains hanging from the walls, blood stains everywhere... You feel a chill run down your back.

You can see latch here.

>up
the latch closed behind you, locking you down here. I wonder how you are going to get out now.

 "HEY WHAT ARE YOU DOING IN MY CASTLE!!! COME HERE I'LL SHOW YOU FIRST HAND WHAT WE DO TO PEOPLE WHO TRY TO STEAL MY STUFF."..... you die as the king brutally murders you with his own fists.

    *** you lose... ***

Would you like to RESTART, RESTORE a saved game, QUIT or UNDO the last command?

* * *

you are an international thief. you heard from a friend that there was a castle in the middle of a forest, and the owner just went out to a dinner party. It is 9:00pm and you have about 2 hours to get in, steal anything precious and get out.

CastleThieves
An Interactive Fiction by Noa Kam
Release 1 / Serial number 170227 / Inform 7 build 6M62 (I6/v6.33 lib 6/12N) SD

castle's border
you see a portcullis, a heavy gate, blocking you from your goal. Are you going to let that stop you? heck no! this is child's play, but really how do you get inside?

You can see portcullis here.

>take all
There are none at all available!

* * *

you are an international thief. you heard from a friend that there was a castle in the middle of a forest, and the owner just went out to a dinner party. It is 9:00pm and you have about 2 hours to get in, steal anything precious and get out.

CastleThieves
An Interactive Fiction by Noa Kam
Release 1 / Serial number 170227 / Inform 7 build 6M62 (I6/v6.33 lib 6/12N) SD

castle's border
you see a portcullis, a heavy gate, blocking you from your goal. Are you going to let that stop you? heck no! this is child's play, but really how do you get inside?

You can see portcullis here.

>u
You can't go that way.

>w
west border
you are west of the castle. a rock wall makes up entire west tower. you see an open window on the upper west tower, maybe you could use your parkour skills and somehow climb up there and get inside.

* * *

>x rock
 

You see a loose rock in the wall, you move it and a couple more rocks fall as well. the dust clears up and you can see a path to the castle. you're in!

>n
(first opening rock wall)
You crawl through the little space and make your way into the west tower.

west tower
You can see rock wall here.

>u
upper west tower
You can see grilled cheese here.

>z
Time passes.

>z
Time passes.

* * *

you are an international thief. you heard from a friend that there was a castle in the middle of a forest, and the owner just went out to a dinner party. It is 9:00pm and you have about 2 hours to get in, steal anything precious and get out.

CastleThieves
An Interactive Fiction by Noa Kam
Release 1 / Serial number 170227 / Inform 7 build 6M62 (I6/v6.33 lib 6/12N) SD

castle's border
you see a portcullis, a heavy gate, blocking you from your goal. Are you going to let that stop you? heck no! this is child's play, but really how do you get inside?

You can see portcullis here.

>w
west border
you are west of the castle. a rock wall makes up entire west tower. you see an open window on the upper west tower, maybe you could use your parkour skills and somehow climb up there and get inside.

>n
You can't go that way.

>x rock wall
You see nothing special about rock wall.

You see a loose rock in the wall, move it a couple more rocks fall as well and you can see a path to the castle. you're in!

>north
(first opening rock wall)

west tower
You can see rock wall here.

* * *

>n
(first opening rock wall)
You crawl through the little space and make your way into the west tower.

west tower
you look around and notice the inside is a lot nice than the rock on the ouside. you see a bunch of bookcases and a spiraling staircase going up.

You can see rock wall and bookshelf (in which are green book, blue book, orange book, fat book, red book, skinny book and black book) here.

>e
courtyard
You are infont of a small grey, old castle. I'm not even sure if you could consider it a castle. It's in the middle of the forrest, which made it very difficult to find in the first place..

>e
east tower
you look around another tower, but this one is filled weapons almost like an armory. in the center of the room you see a stand holding up some shining armor, maybe that's worth something? you also see a staircase leading up, wonder what could be up there?

You can see shining armor, axe and broadsword here.

>take shining armor
Taken.

>wear shining armor
You put on shining armor.

>w
the armor is too heavy, keeping you from moving anywhere.

* * *

>n
(first opening rock wall)
You crawl through the little space and make your way into the west tower.

west tower
you look around and notice the inside is a lot nice than the rock on the ouside. you see a bunch of bookcases and a spiraling staircase going up.

You can see rock wall and bookshelf (in which are green book, blue book, orange book, fat book, red book, skinny book and black book) here.

>u
upper west tower
You can see grilled cheese here.

>take
(grilled cheese)
Taken.

>d
west tower
You can see rock wall here.

>e
courtyard
You are infont of a small grey, old castle. I'm not even sure if you could consider it a castle. It's in the middle of the forrest, which made it very difficult to find in the first place..

* * *

>n
castle
a large room.

>w
west corridor
toddler is playing around in the field, he seems to be completely focused in what he is doing.

>ask toddler about treasure
Im hungy... you must be my baby sitter for tonight. my mommy said my dinner is across the hall. if you get me some food maybe ill talk.

* * *

>open latch
Upon first opening the latch you see a couple cobwebs and a staircase leading down. Are you sure you want to go down the stairway?

>yes
dungeon
A cold mossy room, with chains hanging from the walls, blood stains everywhere... You feel a chill run down your back.

You can see latch here.

>up
the latch closed behind you, locking you down here. I wonder how you are going to get out now.

>up
the latch closed behind you, locking you down here. I wonder how you are going to get out now.

* * *

>e
castle
a large room with a latch in the corner of it... I can't believe I never saw that before.

You can see latch here.

>x castle
You can't see any such thing.

>e
east corridor

>w
castle
a large room with a latch in the corner of it... I can't believe I never saw that before.

You can see latch here.

>w
west corridor
toddler is playing around in the field, he seems to be completely focused in what he is doing.

>i
You are carrying:
  to-do list

>give toddler grilled cheese
(first taking grilled cheese)
That seems to belong to toddler.

>i
You are carrying:
  to-do list

>e
castle
a large room with a latch in the corner of it... I can't believe I never saw that before.

You can see latch here.

* * *

>open latch
Upon first opening the latch you see a couple cobwebs and a staircase leading down. Are you sure you want to go down the stairway?

>d
Please answer yes or no.

>u
Please answer yes or no.

>d
Please answer yes or no.

>yes
dungeon
A cold mossy room, with chains hanging from the walls, blood stains everywhere... You feel a chill run down your back.

You can see latch here.

>up
(first opening latch)
Upon first opening the latch you see a couple cobwebs and a staircase leading down. Are you sure you want to go down the stairway?

* * *

>w
west corridor
toddler is playing around in the field, he seems to be completely focused in what he is doing.

>talk to toddler about treasure
That's not a verb I recognise.

>ask toddler about treasure
Im hungy... you must be my baby sitter for tonight. my mommy said my dinner is across the hall. if you get me some food maybe ill talk.

>give toddler grilled cheese
all right i'll help you. you asked about the treasure? first you have to go down the stairway in the castle, but that is all I can tell you.

>e
castle
a large room.

>down
You can't go that way.

>open stairway
You open stairway.

* * *

>e
courtyard
You are infont of a small grey, old castle. I'm not even sure if you could consider it a castle. It's in the middle of the forrest, which made it very difficult to find in the first place..

>w
west tower
You can see rock wall here.

>e
courtyard
You are infont of a small grey, old castle. I'm not even sure if you could consider it a castle. It's in the middle of the forrest, which made it very difficult to find in the first place..

* * *

>ask toddler about treasure
Im hungy... you must be my baby sitter for tonight. my mommy said my dinner is across the hall. if you get me some food maybe ill talk.

>give toddler grilled cheese
all right i'll help you. you asked about the treasure? first you have to go  in the castle and open the latch in the ground, but that is all I can tell you.

>e
castle
a large room.

* * *

>x rock
 

You see a loose rock in the wall, you move it and a couple more rocks fall as well. the dust clears up and you can see a path to the castle. you're in!

>u
You can't go that way.

>n
(first opening rock wall)
You crawl through the little space and make your way into the west tower.

west tower
you look around and notice the inside is a lot nice than the rock on the ouside. you see a bunch of bookcases and a spiraling staircase going up.

You can see rock wall and bookshelf (in which are green book, blue book, orange book, fat book, red book, skinny book and black book) here.

* * *

>take grilled cheese
Taken.

>x oak table
a small cramped oak table with a lamp, pen, and a bunch of papers spread out all over.

>take paper
Taken.

>x oak table
a small cramped oak table with a lamp, pen, and a bunch of papers spread out all over.

>i
You are carrying:
  paper
  grilled cheese
  to-do list

>x oak table
a small cramped oak table with a lamp, pen, and a bunch of papers spread out all over.

>d
west tower
you look around and notice the inside is a lot nice than the rock on the ouside. you see a bunch of bookcases and a spiraling staircase going up.

You can see rock wall and bookshelf (in which are green book, blue book, orange book, fat book, red book, skinny book and black book) here.

>i
You are carrying:
  paper
  grilled cheese
  to-do list

>d
You can't go that way.

>e
courtyard
You are infont of a small grey, old castle. I'm not even sure if you could consider it a castle. It's in the middle of the forrest, which made it very difficult to find in the first place..

>w
west tower
you look around and notice the inside is a lot nice than the rock on the ouside. you see a bunch of bookcases and a spiraling staircase going up.

You can see rock wall and bookshelf (in which are green book, blue book, orange book, fat book, red book, skinny book and black book) here.

>e
courtyard
You are infont of a small grey, old castle. I'm not even sure if you could consider it a castle. It's in the middle of the forrest, which made it very difficult to find in the first place..

* * *

>e
castle
a large room with a latch in the corner of it... I can't believe I never saw that before.

You can see latch here.

>d
dungeon
A cold mossy room, with chains hanging from the walls, blood stains everywhere... You feel a chill run down your back.

You can see latch here.

>u
the latch closed behind you, locking you down here. I wonder how you are going to get out now.

>take torch
Taken.

* * *

>x rubble
broken rocks, stone, and bricks but if you search around a little more maybe you'll find something of need.

>x rubble
broken rocks, stone, and bricks but if you search around a little more maybe you'll find something of need.

you look around and find a rusty key.

>w
dungeon
A cold mossy room, with chains hanging from the walls, blood stains everywhere... You feel a chill run down your back.

You can see latch here.

>w
west hallway
a long narrow, stone hallway. it is kind of dark as your torch only lights up so much. rubble litters the ground, someone else must have tried to break in recently.

>n
You can't go that way.

>e
dungeon
A cold mossy room, with chains hanging from the walls, blood stains everywhere... You feel a chill run down your back.

You can see latch here.

>e
east hallway
a long narrow, stone hallway. it is kind of dark as your torch only lights up so much. rubble litters the ground, someone else must have tried to break in recently.

You can see rubble here.

* * *

>n
upper east hallway
a long narrow, stone hallway. it is kind of dark as your torch only lights up so much. rubble litters the ground, someone else must have tried to break in recently.

You can see steel door here.

>open steel door
It seems to be locked.

>e
(first opening steel door)
It seems to be locked.

>unlock steel door
What do you want to unlock steel door with?

* * *

>rusty key
You unlock steel door.

>e
(first opening steel door)

treasure room
a small cramped room almost filled to the brim with treasure, whether it be gold, silver, precious jewels, and ornaments.

You can see steel door and King's Treasure here.

>take king's treasure
Taken.

>w
upper east hallway
a long narrow, stone hallway. it is kind of dark as your torch only lights up so much. rubble litters the ground, someone else must have tried to break in recently.

You can see steel door here.

* * *

>s
east hallway
a long narrow, stone hallway. it is kind of dark as your torch only lights up so much. rubble litters the ground, someone else must have tried to break in recently.

You can see rubble here.

>w
dungeon
A cold mossy room, with chains hanging from the walls, blood stains everywhere... You feel a chill run down your back.

You can see latch here.

* * *

>unlock iron door
What do you want to unlock iron door with?

>long key
You can't see any such thing.

>i
You are carrying:
  King's Treasure
  rusty key
  torch (providing light)
  paper
  to-do list

* * *

>w
west border
you are west of the castle. a rock wall makes up entire west tower. you see an open window on the upper west tower, maybe you could use your parkour skills and somehow climb up there and get inside.

>x rock wall
 

You see a loose rock in the wall, move it a couple more rocks fall as well and you can see a path to the castle. you're in!

>north
(first opening rock wall)
You crawl through the little space and make your way into the west tower.

west tower
You can see rock wall here.

* * *

>w
west border
you are west of the castle. a rock wall makes up entire west tower. you see an open window on the upper west tower, maybe you could use your parkour skills and somehow climb up there and get inside.

>x rockwall
You can't see any such thing.

>x rock wall
 

You see a loose rock in the wall, you move it and a couple more rocks fall as well. the dust clears up and you can see a path to the castle. you're in!

* * *

>n
(first opening rock wall)
You crawl through the little space and make your way into the west tower.

west tower
You can see rock wall here.

>s
(first opening rock wall)
You crawl through the little space and make your way into the west tower.

west tower
You can see rock wall here.

>n
You can't go that way.

>n
You can't go that way.

* * *

>w
west border
you are west of the castle. a rock wall makes up entire west tower. you see an open window on the upper west tower, maybe you could use your parkour skills and somehow climb up there and get inside.

>x wall
 

You see a loose rock in the wall, you move it and a couple more rocks fall as well. the dust clears up and you can see a path to the castle. you're in!

>n
(first opening rock wall)
You crawl through the little space and make your way into the west tower.

west tower
You can see rock wall here.

>e
Darkness
It is pitch dark, and you can't see a thing.

>n
castle

>down
You can't go that way.

>s
courtyard
You are infont of a small grey, old castle. I'm not even sure if you could consider it a castle. It's in the middle of the forrest, which made it very difficult to find in the first place..

>n
castle

>n
You can't go that way.

>x court yard
You can't see any such thing.

>s
You can't go that way.

>e
east tower

>w
courtyard

>n
You can't go that way.

* * *

>e
Darkness
It is pitch dark, and you can't see a thing.

>w
dungeon
A cold mossy room, with chains hanging from the walls, blood stains everywhere... You feel a chill run down your back.

>take torch
Taken.

* * *

>e
east hallway
a long narrow, stone hallway. it is kind of dark as your torch only lights up so much. rubble litters the ground, someone else must have tried to break in recently.

You can see rubble here.

>x rubble
broken rocks, stone, and bricks but if you search around a little more maybe you'll find something.

>x rubble
broken rocks, stone, and bricks but if you search around a little more maybe you'll find something.

>x rubble
broken rocks, stone, and bricks but if you search around a little more maybe you'll find something.

you look around and find a rusty key.

* * *

>n
(first opening rock wall)
You crawl through the little space and make your way into the west tower.

west tower
You can see rock wall here.

>n
You can't go that way.

>e
courtyard
You are infont of a small grey, old castle. I'm not even sure if you could consider it a castle. It's in the middle of the forrest, which made it very difficult to find in the first place..

* * *

>w
west corridor
toddler is playing around in the field, he seems to be completely focused in what he is doing.

>talk to toddler
That's not a verb I recognise.

>ask toddler about treasure
Im hungy... you must be my baby sitter for tonight. my mommy said my dinner is across the hall. if you get me some food maybe ill talk.

>x toddler
a young boy who seems oblivious of you coming into the castle. maybe you can try asking him things about the treasure.

* * *

>n
(first opening rock wall)
You crawl through the little space and make your way into the west tower.

west tower
You can see rock wall here.

>take torch
Taken.

>n
north hallway
a long narrow, stone hallway. rubble litters the ground, someone else must have tried to break in recently.

>w
You can't go that way.

>s
dungeon
A cold mossy room, with chains hanging from the walls, blood stains everywhere... You feel a chill run down your back.

>e
east hallway
a long narrow, stone hallway. rubble litters the ground, someone else must have tried to break in recently.

>take rusty key
Taken.

* * *

>take torch
Taken.

>w
west hallway
a long narrow, stone hallway. it is kind of dark as your torch only lights up so much. rubble litters the ground, someone else must have tried to break in recently.

>take rubble
You can't see any such thing.

>x rubble
You can't see any such thing.

>e
dungeon
A cold mossy room, with chains hanging from the walls, blood stains everywhere... You feel a chill run down your back.

>e
east hallway
a long narrow, stone hallway. it is kind of dark as your torch only lights up so much. rubble litters the ground, someone else must have tried to break in recently.

You can see rubble here.

* * *

you are an international thief. you heard from a friend that there was a castle in the middle of a forest, and the owner just went out to a dinner party. It is 9:00pm and you have about 2 hours to get in, steal anything precious and get out.

CastleThieves
An Interactive Fiction by Noa Kam
Release 1 / Serial number 170227 / Inform 7 build 6M62 (I6/v6.33 lib 6/12N) SD

castle's border
you see a portcullis, a heavy gate, blocking you from your goal. Are you going to let that stop you? heck no! this is child's play, but really how do you get inside?

You can see portcullis here.

>west
Darkness
It is pitch dark, and you can't see a thing.

* * *

you are an international thief. you heard from a friend that there was a castle in the middle of a forest, and the owner just went out to a dinner party. It is 9:00pm and you have about 2 hours to get in, steal anything precious and get out.

CastleThieves
An Interactive Fiction by Noa Kam
Release 1 / Serial number 170227 / Inform 7 build 6M62 (I6/v6.33 lib 6/12N) SD

castle's border
you see a portcullis, a heavy gate, blocking you from your goal. Are you going to let that stop you? heck no! this is child's play, but really how do you get inside?

You can see portcullis here.

>x portcullis
a heavy gate that can only be opened from the inside, but you see a keyhole maybe that'll do the trick.

>x keyhole
You can't see any such thing.

>i
You are carrying:
  to-do list

>x to-do list
checklist: before 11:00pm I need to get into the castle, find out where the treasure is, take it, and get out.

>open portcullis
It seems to be locked.

>x castle
You can't see any such thing.

>n
(first opening portcullis)
It seems to be locked.

>e
east border
you are east of the castle. a rock wall makes up entire east tower. on this side the window is closed. there is no way you are getting in through here.

>w
castle's border
you see a portcullis, a heavy gate, blocking you from your goal. Are you going to let that stop you? heck no! this is child's play, but really how do you get inside?

You can see portcullis here.

>w
west border
you are west of the castle. a suspicious rock wall makes up entire west tower, maybe you should check it out. but you also see an open window on the upper west tower, maybe you could use your parkour skills and somehow climb up there and get inside.

You can see window here.

>climb wall
Little is to be achieved by that.

>x window
that windows is way too high for you to get to, even if you had a ladder.

>x tower
You can't see any such thing.

>x rock wall
 

You see a loose rock in the wall, you move it and a couple more rocks fall as well. the dust clears up and you can see a path to the castle. you're in!

>n
(first opening rock wall)
You crawl through the little space and make your way into the west tower.

west tower
you look around and notice the inside is a lot nice than the rock on the outside. you see a bunch of bookcases and a spiraling staircase going up.

You can see rock wall and bookshelf (in which are green book, blue book, orange book, fat book, red book, skinny book and black book) here.

>take green book
Taken.

>take blue book
Taken.

>take orange book
Taken.

>take fat book
Taken.

>x red book
a red book.

>take red book
Taken.

>x skinny book
a skinny book, it would probably take about 2 minutes to read this cover to cover.

>take skinny book
Taken.

>x fat book
a fat book, it must be at least 2000 pages.

>take black book
Taken.

>take all
There are none at all available!

>take rock
That's fixed in place.

>open fat book
It isn't something you can open.

>u
upper west tower
there is nothing much to see up here. just an oak table with a pen and paper, this is probably someone's study. but I guess they ran out of books to put in the shelves up here.

You can see shelves and oak table here.

>x shelves
empty, cobwebs cover the shelves. I wonder if anyone will ever clean this up.

>x table
a small cramped oak table with a lamp, pen, a bunch of papers spread out all over, and a grilled cheese sandwich in the corner.

>take grilled cheese sandwhich
I only understood you as far as wanting to take grilled cheese.

>take grilled cheese
Taken.

>d
west tower
you look around and notice the inside is a lot nice than the rock on the outside. you see a bunch of bookcases and a spiraling staircase going up.

You can see rock wall and bookshelf (empty) here.

>e
courtyard
You are in front of a small grey, old castle. I'm not even sure if you could consider it a castle, because of how small it is

>x castle
You can't see any such thing.

>e
east tower
you look around another tower, but this one is filled weapons almost like an armory. in the center of the room you see a stand holding up some shining armor, maybe that's worth something? you also see a staircase leading up, wonder what could be up there?

You can see shining armor, axe and broadsword here.

* * *

>take shining armor
Taken.

>take axe
it is too heavy for you to pick up. I can't see you really needing an axe for this job anyway.

>take sword
You can't see any such thing.

>take broadsword
it is too heavy for you to pick up. I can't see you realy needed a broadsword for this job anyway.

>u
upper east tower
a room with a master bed, and a nightstand to the left of it. this must be where everyone sleeps.

You can see master bed (on which is blue blanket) and nightstand (on which are lamp and alarm clock) here.

>x blanket
a blue thick blanket used most often in the winter.

>take blanket
Taken.

>x lamp
a white lamp that illuminates the whole room.

>take lap
You can't see any such thing.

>take lamp
it's just a lamp man, you're going to take the king's treasure and his lamp. that's just mean.

>x alarm clock
it is blinking 12:00 AM, the electricity must've gone out sometime recently.

>take alarm clock
it's just an alarm clock man, you're going to take the king's treasure and his lamp. that's just mean.

>take bed
That's fixed in place.

>d
east tower
you look around another tower, but this one is filled weapons almost like an armory. in the center of the room you see a stand holding up some shining armor, maybe that's worth something? you also see a staircase leading up, wonder what could be up there?

You can see axe and broadsword here.

>w
courtyard
You are in front of a small grey, old castle. I'm not even sure if you could consider it a castle, because of how small it is

>w
west tower
you look around and notice the inside is a lot nice than the rock on the outside. you see a bunch of bookcases and a spiraling staircase going up.

You can see rock wall and bookshelf (empty) here.

>e
courtyard
You are in front of a small grey, old castle. I'm not even sure if you could consider it a castle, because of how small it is

>e
east tower
you look around another tower, but this one is filled weapons almost like an armory. in the center of the room you see a stand holding up some shining armor, maybe that's worth something? you also see a staircase leading up, wonder what could be up there?

You can see axe and broadsword here.

>w
courtyard
You are in front of a small grey, old castle. I'm not even sure if you could consider it a castle, because of how small it is

>n
castle
a large grand room, surrounded by stone walls, with a lit candle chandelier on the ceiling.

You can see candle chandelier here.

>x chandelier
a golden lit candle chandelier bright enough to light up the entire castle.

>take chandelier
are you kidding me it's on the ceiling, how are you going to get up there.

>s
courtyard
You are in front of a small grey, old castle. I'm not even sure if you could consider it a castle, because of how small it is

>n
castle
a large grand room, surrounded by stone walls, with a lit candle chandelier on the ceiling.

You can see candle chandelier here.

* * *

>n
north corridor
a grassy open field, with a couple trees and a garden surrounded by a rock wall encasing the entire property.

toddler is playing around in the field, he seems to be completely focused in what he is doing.

>take toddler
I don't suppose toddler would care for that.

>x toddler
a young boy who seems oblivious of you coming into the castle. maybe you can try asking him things about the treasure.

>ask toddler about treasure
I'm hungry... you must be my baby sitter for tonight. my mommy said my dinner is across the hall. if you get me some food maybe I'll talk.

* * *

>s
castle
a large grand room, surrounded by stone walls, with a lit candle chandelier on the ceiling, with a latch in the corner of it... I can't believe I never saw that before.

You can see latch and candle chandelier here.

>s
courtyard
You are in front of a small grey, old castle. I'm not even sure if you could consider it a castle, because of how small it is

>n
castle
a large grand room, surrounded by stone walls, with a lit candle chandelier on the ceiling, with a latch in the corner of it... I can't believe I never saw that before.

You can see latch and candle chandelier here.

you hear a clock strike 10 times, looks like it's 10 o'clock the owner of the castle is going to be home in just about another hour. better hurry up!

>open latch
Upon first opening the latch you see a couple cobwebs and a staircase leading down. Are you sure you want to go down the stairway?

* * *

>yes
dungeon
A cold mossy room lit by a torch, with chains hanging from the walls, blood stains everywhere... You feel a chill run down your back.

You can see latch here.

>open latch
Upon first opening the latch you see a couple cobwebs and a staircase leading down. Are you sure you want to go down the stairway?

* * *

>yes
dungeon
A cold mossy room lit by a torch, with chains hanging from the walls, blood stains everywhere... You feel a chill run down your back.

You can see latch here.

>n
Darkness
It is pitch dark, and you can't see a thing.

>d
You can't go that way.

>s
dungeon
A cold mossy room lit by a torch, with chains hanging from the walls, blood stains everywhere... You feel a chill run down your back.

You can see latch here.

>e
Darkness
It is pitch dark, and you can't see a thing.

>w
dungeon
A cold mossy room lit by a torch, with chains hanging from the walls, blood stains everywhere... You feel a chill run down your back.

You can see latch here.

>e
Darkness
It is pitch dark, and you can't see a thing.

>n
Darkness
It is pitch dark, and you can't see a thing.

>s
Darkness
It is pitch dark, and you can't see a thing.

>w
dungeon
A cold mossy room lit by a torch, with chains hanging from the walls, blood stains everywhere... You feel a chill run down your back.

You can see latch here.

>w
Darkness
It is pitch dark, and you can't see a thing.

>e
dungeon
A cold mossy room lit by a torch, with chains hanging from the walls, blood stains everywhere... You feel a chill run down your back.

You can see latch here.

>e
Darkness
It is pitch dark, and you can't see a thing.

* * *

>w
dungeon
A cold mossy room lit by a torch, with chains hanging from the walls, blood stains everywhere... You feel a chill run down your back.

You can see latch here.

>x latch
You see nothing special about latch.

>open latch
Upon first opening the latch you see a couple cobwebs and a staircase leading down. Are you sure you want to go down the stairway?

* * *

>n
Darkness
It is pitch dark, and you can't see a thing.

>s
dungeon
A cold mossy room lit by a torch, with chains hanging from the walls, blood stains everywhere... You feel a chill run down your back.

You can see latch here.

* * *

>take torch
Taken.

>n
north hallway
a long narrow, stone hallway. it is kind of dark as your torch only lights up so much. rubble litters the ground, someone else must have tried to break in recently.

You can see debris here.

* * *

>x debris
broken tiles, dirt, and rocks clutter the ground but if you search around a little more maybe you'll find something or need.

>x dirt
You can't see any such thing.

>x tiles
You can't see any such thing.

>x broken tiles
You can't see any such thing.

>x stone hallway
You can't see any such thing.

>x rubble
You can't see any such thing.

>x rubble litters
You can't see any such thing.

>x rocks
You can't see any such thing.

>x ground
You can't see any such thing.

>s
dungeon
A cold mossy room lit by a torch, with chains hanging from the walls, blood stains everywhere... You feel a chill run down your back.

You can see latch here.

>e
east hallway
a long narrow, stone hallway. it is kind of dark as your torch only lights up so much. rubble litters the ground, someone else must have tried to break in recently.

You can see rubble here.

>x rubble
broken rocks, stone, and bricks cover the floor keeping you from seeing the ground, which could be hiding something from you.

>x broken rocks
You can't see any such thing.

>x stones
You can't see any such thing.

>n
upper east hallway
a long narrow, stone hallway. it is kind of dark as your torch only lights up so much. rubble litters the ground, someone else must have tried to break in recently.

You can see steel door here.

>x steel door
You see nothing special about steel door.

>open steel door
It seems to be locked.

>s
east hallway
a long narrow, stone hallway. it is kind of dark as your torch only lights up so much. rubble litters the ground, someone else must have tried to break in recently.

You can see rubble here.

>x hallway
You can't see any such thing.

>x rubble
broken rocks, stone, and bricks cover the floor keeping you from seeing the ground, which could be hiding something from you.

>x ground
You can't see any such thing.

>w
dungeon
A cold mossy room lit by a torch, with chains hanging from the walls, blood stains everywhere... You feel a chill run down your back.

You can see latch here.

* * *

>w
west hallway
a long narrow, stone hallway. it is kind of dark as your torch only lights up so much. rubble litters the ground, someone else must have tried to break in recently.

>x rubble
You can't see any such thing.

>w
You can't go that way.

>e
dungeon
A cold mossy room lit by a torch, with chains hanging from the walls, blood stains everywhere... You feel a chill run down your back.

You can see latch here.

* * *

>look under rubble
you move the rubble a little to reveal a little rusty key.

>take key
You already have that.

>i
You are carrying:
  rusty key
  torch (providing light)
  blue blanket
  shining armor
  black book
  skinny book
  red book
  fat book
  orange book
  blue book
  green book
  to-do list

>w
dungeon
A cold mossy room lit by a torch, with chains hanging from the walls, blood stains everywhere... You feel a chill run down your back.

You can see latch here.

>n
north hallway
a long narrow, stone hallway. it is kind of dark as your torch only lights up so much. rubble litters the ground, someone else must have tried to break in recently.

You can see debris here.

>s
dungeon
A cold mossy room lit by a torch, with chains hanging from the walls, blood stains everywhere... You feel a chill run down your back.

You can see latch here.

* * *

>n
upper east hallway
a long narrow, stone hallway. it is kind of dark as your torch only lights up so much. rubble litters the ground, someone else must have tried to break in recently.

You can see steel door here.

>unlock door with key
You unlock steel door.

>e
(first opening steel door)

treasure room
a small cramped room almost filled to the brim with treasure, whether it be gold, silver, precious jewels, and ornaments.

You can see steel door, King's Treasure and long key here.

>take long key
Taken.

>take treasure
Taken.

>take all
There are none at all available!

>take gold
You can't see any such thing.

>w
upper east hallway
a long narrow, stone hallway. it is kind of dark as your torch only lights up so much. rubble litters the ground, someone else must have tried to break in recently.

You can see steel door here.

* * *

>w
dungeon
A cold mossy room lit by a torch, with chains hanging from the walls, blood stains everywhere... You feel a chill run down your back.

You can see latch here.

>u
the latch closed behind you, locking you down here. I wonder how you are going to get out now.

>e
east hallway
a long narrow, stone hallway. it is kind of dark as your torch only lights up so much. rubble litters the ground, someone else must have tried to break in recently.

You can see rubble here.

* * *

>n
upper east hallway
a long narrow, stone hallway. it is kind of dark as your torch only lights up so much. rubble litters the ground, someone else must have tried to break in recently.

You can see steel door here.

>e
treasure room
a small cramped room almost filled to the brim with treasure, whether it be gold, silver, precious jewels, and ornaments.

You can see steel door here.

* * *

>w
upper east hallway
a long narrow, stone hallway. it is kind of dark as your torch only lights up so much. rubble litters the ground, someone else must have tried to break in recently.

You can see steel door here.

>e
treasure room
a small cramped room almost filled to the brim with treasure, whether it be gold, silver, precious jewels, and ornaments.

You can see steel door here.

* * *

>s
east hallway
a long narrow, stone hallway. it is kind of dark as your torch only lights up so much. rubble litters the ground, someone else must have tried to break in recently.

You can see rubble here.

>w
dungeon
A cold mossy room lit by a torch, with chains hanging from the walls, blood stains everywhere... You feel a chill run down your back.

You can see latch here.

you hear a clock strike 11 times, looks like it's 11 o'clock the owner of the castle should be hoom real soon. now we really need to hurry up!

>w
west hallway
a long narrow, stone hallway. it is kind of dark as your torch only lights up so much. rubble litters the ground, someone else must have tried to break in recently.

* * *

>s
lower west hallway
a long narrow, stone hallway. it is kind of dark as your torch only lights up so much. rubble litters the ground, someone else must have tried to break in recently.

You can see iron door here.

>x door
You see nothing special about iron door.

>open door
It seems to be locked.

>unlock door with long key
You unlock iron door.

>w
    *** you escaped with the treasure and not even a drip of sweat, congratulation! ***

Would you like to RESTART, RESTORE a saved game, QUIT or UNDO the last command?

* * *

you are an international thief. you heard from a friend that there was a castle in the middle of a forest, and the owner just went out to a dinner party. It is 9:00pm and you have about 2 hours to get in, steal anything precious and get out.

CastleThieves
An Interactive Fiction by Noa Kam
Release 1 / Serial number 170227 / Inform 7 build 6M62 (I6/v6.33 lib 6/12N) SD

castle's border
you see a portcullis, a heavy gate, blocking you from your goal. Are you going to let that stop you? heck no! this is child's play, but really how do you get inside?

You can see portcullis here.

>z
Time passes.

I beg your pardon?

>z
Time passes.

>zz
That's not a verb I recognise.

>z
Time passes.

>z
Time passes.

you hear a clock strike 10 times, looks like it's 10 o'clock the owner of the castle is going to be home in just about another hour. better hurry up!

>z
Time passes.

>z
Time passes.

you hear a clock strike 11 times, looks like it's 11 o'clock the owner of the castle should be hoom real soon. now we really need to hurry up!

>z
Time passes.

>z
Time passes.

 "HEY WHAT ARE YOU DOING IN MY CASTLE!!! COME HERE I'LL SHOW YOU FIRST HAND WHAT WE DO TO PEOPLE HOW TRY TO STEAL MY STUFF."..... you die as the king brutally murders you with some nails, and a hammer.

    *** you lose... ***

Would you like to RESTART, RESTORE a saved game, QUIT or UNDO the last command?

>z
Please give one of the answers above.

Would you like to RESTART, RESTORE a saved game, QUIT or UNDO the last command?

>z
Please give one of the answers above.

Would you like to RESTART, RESTORE a saved game, QUIT or UNDO the last command?